              
 ************ 
 *            
 *   *** **** 
 *** * * *  * 
 * * * * *  * 
 * *   * ** *
 * *** *  * * 
 *   * *  * * 
 * *** *  * * 
 * *   *  * * 
 * *   * ** * 
 *   *** *  * 
 * *** * *  *
 * *   * ** * 
            *
 ************ 
              