wwwwwwwwww
w********w
w**w*****w
w***w****w
w***w****w
w***w****w
w******w*w
w*w******w
w***w****w
wwwwwwwwww