wwwwwwwwww
w********w
w**w**s**w
w***w****w
w***w**s*w
w***w****w
w******w*w
w*w******w
w***w****w
wwwwwwwwww