wwwwwwwwww
w********w
w****s***w
w*******sw
w***ss***w
w********w
w******w*w
w*w******w
w***w****w
wwwwwwwwww